###########
#         #
#   X     #
# O     ###
#     P   #
# OX      #
###########
